1111110
1000011
1000011
1110001
1110001
1111111
