1111111
1011111
101P0E1
1000111
111CC01
1111111
